ssssssssssssssss
s--------------s
s--------------s
s---t----------s
s---p----------s
s--------------s
ssssssssssssssss