ssssssssssssssss
s----y---------s
s----c----t----s
s---t------y---s
s---p-------c--s
s-------t------s
ssssssssssssssss